%%%%%%%%%%%%%%%%%%%%
% . . . % . . . . .%
% %%% % % %%% %%% .%
% % . . . % . . % .%
% % %%% % % %%% % .%
% . . . % . . . % .%
% %%% % % %%% % % .%
% P . . . . . . % .%
%%%%%%%%%%%%%%%%%%%%